
5ffffffffafffff6
ept      e   t e
e 0 5ff1 2 0 0 e
e e ex   t e e e
epe 2t3ff1 e e e
e e        e e e
e e 5ffffff7 e e
epe e        e e
e 4f8fff1 3ff7 e
e              e
4ffffffffffffff7